0000000000000000000000000000000000000000000000000000000000000000000000000000000000000000000000000000
0000000000000000000000000000000000000000000000000000000000000000000000000000000000000000000000000000
1111111011111110000100000111110010000000111111100001000000000000000000000000000000000000000000000000
1000000010000010001010000100010010000000100000000010100000000000000000000000000000000000000000000000
1000000010000010001010000100010010000000100000000010100000000000000000000000000000000000000000000000
1000000011111100011111000100010011111110111111100111110000000000000000000000000000000000000000000000
1000000010000010010001000111110010000010100000100100010000000000000000000000000000000000000000000000
1000000010000010100000101000001010000010100000101000001000000000000000000000000000000000000000000000
1111111011111110100000101000001011111110111111101000001000000000000000000000000000000000000000000000
0000000000000000000000000000000000000000000000000000000000000000000000000000000000000000000000000000
0000000000000000000000000000000000000000000000000000000000000000000000000000000000000000000000001000
0000000000000000000000000000000000000000000000000000000000000000000000000000000000000000000000001000
0000000000000000000000000000000000000000000000000000000000000000000000000000000000000000000000001000
0000000000000000000000000000000000000000000000000000000000000000000000000000000000000000000000001001
0000000000000000000000000000000000000000000000000000000000000000000000000000000000000000000000001010
0000000000000000000000000000000000000000000000000000000000000000000000000000000000000000000000001100
0000000000000000000000000000000000000000000000000000000000000000000000000000000000000000000000001000
0000000000000000000000000000000000000000000000000000000000000000000000000000000000000000000000000000
0000000000000000000000000000000000000000000000000000000000000000000000000000000000000000000000000000
0000000000000000000000000000000000000000000000000000000000000000000000000000000000000000000000000000
0000000000000000000000000000000000000000000000000000000000000000000000000000000000000000000000000000
0000000000000000000000000000000000000000000000000000000000000000000000000000000000000000000000000000
0000000000000000000000000000000000000000000000000000000000000000000000000000000000000000000000000001
0000000000000000000000000000000000000000000000000000000000000000000000000000000000000000000000000001
0010000000000000000000000000000000000000000000000000000000000000000000000000000000000000000000000001
0101000000000000000000000000000000000000000000000000000000000000000000000000000000000000000000000001
0101000000000000000000000000000000000000000000000000000000000000000000000000000000000000000000000001
1111100000000000000000000000000000000000000000000000000000000000000000000000000000000000000000000001
1000100000000000000000000000000000000000000000000000000000000000000000000000000000000000000000000001
0000010000000000000000000000000000000000000000000000000000000000000000000000000000000000000000000000
0000010000000000000000000000000000000000000000000000000000000000000000000000000000000000000000000000
0000000000000000000000000000000000000000000000000000000000000000000000000000000000000000000000000000
0000000000000000000000000000000000000000000000000000000000000000000000000000000000000000000000000000
0000000000000000000000000000000000000000000000000000000000000000000000000000000000000000000000000000
0000000000000000000000000000000000000000000000000000000000000000000000000000000000000000000000000000
0000000000000000000000000000000000000000000000000000000000000000000000000000000000000000000000000000
0000000000000000000000000000000000000000000000000000000000000000000000000000000000000000000000000000
0000000000000000000000000000000000000000000000000000000000000000000000000000000000000000000000000000
0000000000000000000000000000000000000000000000000000000000000000000000000000000000000000000000000000
0000000000000000000000000000000000000000000000000000000000000000000000000000000000000000000000000000
0000000000000000000000000000000000000000000000000000000000010000010000100001111111000010000100000100
0000000000000000000000000000000000000000000000000000000000010001100001010000001000000101000100011000
0000000000000000000000000000000000000000000000000000000000010110000001010000001000000101000101100000
0000000000000000000000000000000000000000000000000000000000011000000011111000001000001111100110000001
0000000000000000000000000000000000000000000000000000000000010110000010001000001000001000100101100000
0000000000000000000000000000000000000000000000000000000000010001100100000100001000010000010100011000
0000000000000000000000000000000000000000000000000000000000010000010100000100001000010000010100000100
0000000000000000000000000000000000000000000000000000000000000000000000000000000000000000000000000000
0000000000000000000000000000000000000000000000000000000000000000000000000000000000000000000000000000
0000000000000000000000000000000000000000000000000000000000000000000000000000000000000000000000000000
0000000000000000000000000000000000000000000000000000000000000000000000000000000000000000000000000000
0000000000000000000000000000000000000000000000000000000000000000000000000000000000000000000000000000
0000000000000000000000000000000000000000000000000000000000000000000000000000000000000000000000000000
0000000100000101000001010000010000100001111111000010000000000000000000000000000000000000000000000000
0000000110001101000011010000010001010001000000000101000000000000000000000000000000000000000000000000
0000000101010101000101010000010010001001000000000101000000000000000000010000010100000101111111000010
0000000100100101001001011111110110001101000000001111100000000000000000010000010010001001000000000101
0000000100000101010001010000010010001001000000001000100000000000000000010000010001010001000000000101
0000000100000101100001010000010001010001000000010000010000000000000000011111110000100001000000001111
0000000100000101000001010000010000100001000000010000010000000000000000010000010001000001000000001000
0000000000000000000000000000000000000000000000000000000000000000000000010000010010000001000000010000
0000000000000000000000000000000000000000000000000000000000000000000000010000010100000001000000010000
0000000000000000000000000000000000000000000000000000000000000000000000000000000000000000000000000000
0000000000000000000000000000000000000000000000000000000000000000000000000000000000000000000000000000
0000000000000000000000000000000000000000000000000000000000000000000000000000000000000000000000000000
0000000000000000000000000000000000000000000000000000000000000000000000000000000000000000000000000000
0000000000000000000000000000000000000000000000000000000000000000000000000000000000000000000000000000
0000000000000000000000000000000000000000000000000000000000000000000000000000000000000000000000000000
0000000000000000000000000000000000000000000000000000000000000000000000000000000000000000000000000000
0000000000000000000000000000000000000000000000000000000000000000000000000000000000000000000000000000
0000000000000000000000000000000000000000000000000000000000000000000000000000000000000000000000000000
0000000000000000000000000000000000000000000000000000000000000000000000000000000000000000000000000000
0000000000000000000000000000000000000000000000000000000000000000000000000000000000000000000000000000
0000000000000000000000000000000000000000000000000000000000000000000000000000000000000000000000000000
0000000000000000000000000000000000000000000000000000000000010000100000100100010011111110000100000000
0000000000000000000000000000000000000000000000000000000000101000110001100000000010000000001010000000
0000000000000000000000000000000000000000000000000000000001000100101010101111111010000000001010000000
0000000000000000000000000000000000000000000000000000000011000110100100101000000010000000011111000000
1000001011111110000100000000000000000000000000000000000001000100100000101111111010000000010001000000
1000001010000010001010000000000000000000000000000000000000101000100000101000000010000000100000100000
1000001010000010001010000000000000000000000000000000000000010000100000101111111010000000100000100000
1111111011111100011111000000000000000000000000000000000000000000000000000000000000000000000000000000
0000001010000010010001000000000000000000000000000000000000000000000000000000000000000000000000000000
0000001010000010100000100000000000000000000000000000000000000000000000000000000000000000000000000000
0000001011111110100000100000000000000000000000000000000000000000000000000000000000000000000000000000
0000000000000000000000000000000000000000000000000000000000000000000000000000000000000000000000000000
0000000000000000000000000000000000000000000000000000000000000000000000000000000000000000000000000000
0000000000000000000000000000000000000000000000000000000000000000000000000000000000000000000000000000
0000000000000000000000000000000000000000000000000000000000000000000000000000000000000000000000000000
0000000000000000000000000000000000000000000000000000000000000000000000000000000000000000000000000000
0000000000000000000000000000000000000000000000000000000000000000000000000000000000000000000000000000
0000000000000000000000000000000000000000000000000000000000000000000000000000000000000000000000000000
0000000000000000000000000000000000000000000000000000000000000000000000000000000000000000000000000000
0000000000000000000000000000000010000000100001000001011111110000100000000000000000000000000000000000
0000000000000000000000000000000101000001010001000001010000000001010000000000000000000000000000000000
0000000000000000000000000000000101000010001001000001010000000001010000000000000000000000000000000000
0000000000000000000000000000001111100010001001111111011111110011111000000000000000000000000000000000
0000000000000000000000000000001000100100000100000001010000010010001000000000000000000000000000000000
0000000000000000000000000000010000010100000100000001010000010100000100000000000000000000000000000000
0000000000000000000000000000010000010100000100000001011111110100000100000000000000000000000000000000
